One day I felt this hatred |towards Germans|and I still feel ashamed
Somehow they deserve it|sometimes
We don't want a new Hitler|reigning over Europe
How can we trust|those from the south?
We need to share|all the same values
We need to keep our own|personality as a people
How can I tolerate you|if you're so different?
How can I find you appealing|if you're so similar? 
Stronger together
Safer alone
We want to recover|our autonomy
We want to travel free
We don't even speak|the same language
I love speaking|your language
Il processo di Bologna mira|a rendere più coerenti|i sistemi di istruzione|superiore in Europa
Tale la musa ride fuggente|al verso in cui trema|un desiderio vano|de la bellezza antica.
De Commissie ziet toe|op de ontwikkeling|van de begrotingssituatie
Om het jaar kwamen de|beste dichters van de wereld|naar Maastricht voor een|uniek poëziefestival
Le seuil de la majorité|qualifiée a été|au centre des débats|de la CIG de Nice
Lei Niçard embé|lei Prouvençau|soun toujour esta coumo|lou can e lou cat
O Tratado de Lisboa|reforçou os poderes financeiro,|legislativo e de supervisão|do Parlamento Europeu.
Navegadores antigos|tinham uma frase gloriosa:|"Navegar é preciso;|viver não é preciso”
On a rien contre eux|mais qu’ils rentrent chez eux
Tout le monde déteste|les douaniers
We don’t have anything|against them,|as long as they stay home
Everybody hates custom officers
On a rien contre eux|mais qu'ils restent chez eux!
Tout le monde déteste les douaniers
I want my money back from Brussel!
Did you see the state|of their railway system?!
En coloc Erasmus, même quand t’es Serbe,|une fois que t’as fait des pâtes | à ton coloc croate, | tu lui casses pas la gueule!
On n’a pas les mêmes|régimes alimentaires,| ça ne marchera jamais
de Riga à Porto|d’Odessa à Brest|partout la mer
Cette peste|qui vient d’ailleurs
Les latins: des branleurs
Les germains: des pas drôles
Latins ? Lazy
Germanic people? Not funny
Que les lybiens restent chez eux
Je déteste les douaniers
On va pas laisser Bruxelles décider pour nous
Il faut lutter contre l’hégémonie chinoise
Erasmus :|le gouffre financier
Mes enfants méritent|d’étudier dans les|meilleures universités
Erasmus:|it costs us a fortune!!!
My children deserve|to study abroad!
La politique agricole commune :|un gouffre financier
Après des siècles de famine… soyons modernes!
L’Europe ? Il faudrait au moins|tous parler la même langue
Défendons les langues|régionales minoritaires !
Lombardie / Calabre,|Allemagne / Grêce :|il faut plus de solidarité
Lombardie / Calabre,|Allemagne / Grêce :|c’est toujours les mêmes qui payent
